龙舟（打一歌曲名)	中国船
龙（打一成语）	充耳不闻
齐楚燕赵皆降服（打《史记》一句）	四国顺之
齐唱（打一成语）	异口同声
鼻子像钩子，耳朵像扇子。大腿像柱子，尾巴像鞭子。（打一动物名	象
鼠年迎春（打一字)	李
鼠头虎尾,猜一字 	儿 
黯（打一成语）	有声有色
黑脸包丞相，坐在大堂上。扯起八卦旗，专拿飞天将。（打一动物名	蜘蛛
黑狗（打一字)	默
黑板报（打一成语）	白字连篇
黄河大合唱（打一歌曲名)	摇篮曲
鹧鸪飞去十里亭 ,猜四个字 	鸾凤和鸣 
鹊巢鸦占（打一成语）	化为乌有
鸿鸟飞（打江西一地名）	余江
鸡又飞了（打一字)	鸟
鸟宿林间不再飞（打《三国演义》人名一)	关羽
鲛人挥泪（打一中草药名)	珍珠散
鲁达当和尚（打一成语）	半路出家
鲁人经商（打《前出师表》一句）	愚以为营中之事
鬼脸儿善变 （打江苏一地名）	兴化
鬼头山（打一字）	嵬
高尔基（打一字）	尚
骡（打一成语）	非驴非马
骑兵凯旋（打一词牌名)	马头调
骇人听闻,猜一个字 	诡 
驿站（打河南一地名)	驻马店
驿外断桥边（打一字）	骄
驼背老公公，胡子乱蓬蓬。生前没有血，死后满身红。（打一动物名	虾
驼峰（打一安徽地名)	马鞍山
驯狗者,猜一字 	狮 
馨香飘逝,闻香无门,猜一字 	声 
香山秋艳（打一中草药名)	一片丹
香凝最解稚儿心（打《滕王阁序》一句）	童子何知
饭（打一字）	糙
饥荒 ,猜一个字 	欲 
飞鸣镝（打一成语）	弦外之音
飞行员（打一成语）	有机可乘
飞花满四邻（打西藏一地名）	谢通门
飞砂走石,猜一字 	少 
飞将军自重霄入（打《滕王阁序》一句）	李广难封
飞将军之子（打《水浒传》人物绰号一)	小李广
风物长宜放眼量（打安徽一地名）	怀远
风儿吐舌头 ,猜一个字 	刮 
风云可测（打《水浒传》人物绰号一)	摸着天
颠鸾倒凤（打一戏剧名)	女驸马
颠三倒四（打一字）	泪
顶破天（打一字）	夫
非正式协定（打一字）	药
静静的顿河（打山西一地名）	文水
静观待变（打福建一地名）	宁化
青龙白虎照秦镜（打一歌曲名)	二泉映月
青梅竹马两无猜（打《前出师表》一句）	亲小人
青梅竹马（打《孙子兵法》一句）	少而往来者
青梅煮酒论英雄（打一歌曲名)	只有你和我
霸王自刎。	翠
雷而无雨,猜一个字 	田 
雷电之后（打一中草药名)	阴阳水
零落成泥碾作尘（打一中草药名)	沉香粉
零存整取（打一成语）	积少成多
雨披（打一成语）	一衣带水
雨（打一字）	池
集资共建，大桥贯通（打重庆一地名）	铜梁
雄踞山寨（打吉林一地名）	公主岭
雄心纵横行无阻（打海南一地名）	通什
雁双飞（打一字）	从
难过皆因负担重（打一中草药名)	薄荷通
难以称呼（打一中草药名)	无名子
除夕残年又逢春（打一字）	桀
陕西人十分好（打一字）	附
陈玉成（打一字）	瑛
阻街女郎,猜一字 	接 
阴曹地府,猜一个字 	块 
阳关一曲续日弹（打《三国演义》人名一)	曹操
防暑降温见成效（打一中草药名)	抗炎灵
阎罗王,猜一字 	瑰 
闻不用耳,猜一个字 	门 
闻不入耳,猜一字 	门 
门里阳光照,门外雨飘飘,猜一个字 	涧 
门外汉（打《论语》一句）	未入于室也
门外来人月已斜,猜一字 	闲 
长跑冠军（打《水浒传》人物绰号一)	神行太保
长胳膊，猴儿脸。大森林里玩得欢。摘野果，捣鹊蛋，抓住树枝荡秋千。（打一动物名	长臂猿
长江后浪推前浪（打西藏一地名）	波密
长明灯 ,猜一个字 	灸 
长得像黄菊，引诱小鱼虾。触手捕食物，舞爪又张牙。（打一动物名	海葵
长安一片月（打《水浒传》人名一)	秦明
长剑在握镇东吴（打《孙子兵法》一句）	因利而制权民
镜中人,猜一字 	入 
镜中人,猜一个字 	入 
银楼,猜一字 	锯 
钱多才可做东（打北京一地名）	大有庄
钦差大臣满天飞（打《红楼梦》人名一)	多官儿
钟馗,猜一字 	瑰 
金银铜铁珠翠钻（打上海一地名）	七宝
金钿遍野（打一中草药名)	地黄
金环银环（打《水浒传》人物绰号一)	两头蛇
金木水火,猜一字 	坎 
金字塔,猜一字 	鑫 
重点干起，秋前方成（打天津一地名）	和平
重新制作（打一中草药名)	再造丸
醉翁之意不在酒（打一歌曲名)	好山好水好地方
酒肉朋友,猜一个字 	饺 
酒中没有水,简直活见鬼,猜一字 	丑 
部位相反,猜一字 	陪 
邮差,猜一字 	储 
那个愿臣虏自认（打贵州一地名）	安顺
遥指红楼是妾家（打一字）	舒
道旁栽草（打一中草药名)	路边青
遇事不求人（打一成语）	自力更生
逢人只说三句话（打一文学名词)	七言绝句
造极摩天（打一中草药名)	千层塔
逐渐繁荣（打《三国演义》人名一)	徐盛
逆水划船（打一成语）	力争上游
送走观音使不得（打一字）	还
退席（打《论语》一句）	不在其位
退休（打《论语》一句）	老者安之
连接各户（打一中草药名)	贯众
连声应允（打一字）	哥
连中三元,猜一字 	车 
远看像黄球，近看毛茸茸。叽叽叽叽叫，最爱吃小虫。（打一动物名	小鸡
远看像只猫，近看是只鸟。晚上捉田鼠，天亮睡大觉。（打一动物名	猫头鹰
远看两个零，近看两个零。有人用了行不得，有人不用不得行。（打一日常用品	眼镜
进洞像龙，出洞像凤。凤生百子，百子成龙。（打一动物名	蚕
进水行不成（打一字）	衍
这一页,猜一字 	题 
返老还童（打一中草药名)	老来少
近朱者赤,猜一字 	赫 
过分要求（打《水浒传》人名一)	索超
边打边谈,猜一字 	订 
辣椒市场（打河北一地名）	辛集
轻骑飞跃（打《三国演义》人名一)	马超
轻描柳叶（打一动物名	画眉
车谱（打一歌曲名)	四季歌
车上有只老虎 ,猜一个字 	递 
身长约一丈，鼻生头顶上。背黑肚皮白，安家在海洋。（打一动物名	海豚
身轻如燕（打《水浒传》人物绰号一)	鼓上蚤
身穿绿衣裳，肩扛两把刀。庄稼地里走，害虫吓得跑。（打一动物名	螳螂
身穿绿色衫，头戴五花冠。喝的清香酒，唱如李翠莲。（打一动物名	蝈蝈
身穿红衣裳，常年把哨放，遇到紧急事，敢往火里闯。（打一日常用品	灭火器
身小力不小，团结又勤劳。有时搬粮食，有时挖地道。（打一动物名	蚂蚁
身子轻如燕，飞在天地间。不怕相隔远，也能把话传。（打一动物名	信鸽
身为王储哪得穷（打《滕王阁序》一句）	君子安贫
身上滑腻腻，喜欢钻河底。张嘴吐泡泡，可以测天气。（打一动物名	泥鳅
踏花归来蝶绕膝（打一中草药名)	香附
超级骗子之言（打香港一地名）	大坑道
超级好牙刷（打一成语）	一毛不拔
起死回生,猜一个字 	苏
起死回生,猜一个字 	苏 
起宏图（打一中草药名)	远志
赫赫小英雄（打《水浒传》人名一)	童威
赤兔（打一字)	驰
赛跑冠军 ,猜一个字 	道 
贵在廉洁（打黑龙江一地名）	宝清
财源茂盛达三江（打广西一地名）	富川
贝字减两点 , 不作目字猜,猜一个字 	资 
谢绝参观（打一字）	企
谈笑风生（打一文学名词)	即兴诗
请十二时准时入席,猜一字 	许 
请勿过虑（打《孟子》一句）	求其放心而已矣
说马不像马，路上没有它。若用它做药，要到海中抓。（打一动物名	海马
说话的技术（打一字）	团
许仙（打一电视剧名)	蛇郎
讲鬼,猜一字 	魂 
讲故事（打一中草药名)	向前
讲师钟点费,猜一字 	读 
计划承包田（打《孙子兵法》一句）	围地而谋
詈冤家,言去难留   	四
视而不见,猜一个字 	示 
观不见鸟飞来,猜一个字 	鹳
观不见鸟飞来,猜一个字 	鹳 
见先进就学（打《孙子兵法》一句）	良将随之
见人就笑,猜一字 	竺 
见人就笑          	竺
西施（打一字）	俪
西安相聚之日（打一字）	晒
裹脚,猜一个字 	跑 
衔泥筑新居（打《红楼梦》人名一)	春燕
行千里路,猜一字 	冲 
血盆（打一字）	唬
蜜饯黄连（打一成语）	同甘共苦
蜜罐城（打宁夏一地名）	甜水堡
虫入凤巢飞去鸟,猜一字 	风 
虚有其表要不得（打一中草药名)	云实
虚心话（打一文学名词)	七言
董卓鸩酒杀少帝（打《史记》一句）	以臣弑君
落英缤纷（打一中草药名)	降香
落花人独立 , 微雨燕双飞,猜一个字 	俩 
落红有主（打辽宁一地名）	丹东
营业员标兵（打《红楼梦》人名一)	贾范
菊花分外香（打《红楼梦》人名一)	秋芳
莫让年华付水流（打一中草药名)	青春宝
莫中美人计（打《论语》一句）	戒之在色
草色遥看近却无（打《红楼梦》人名一)	碧痕
草木之中有个人 ,猜一个字 	茶 
草上飞,猜一字 	早 
苗头不对,猜一字 	笛 
花和尚鲁智深（打四川一地名）	色达
芙蓉帐暖度春宵（打新疆一地名）	温宿
艳阳天却听雷声（打贵州一地名）	晴隆
艳冠群芳（打《水浒传》人名一)	王英
船板硬，船面高。四把桨，慢慢摇。（打一动物名	乌龟
航道（打一字）	潞
舌头没有,猜一个字 	古 
自言自语,猜一字 	记 
自有一日出头天,猜一字 	春 
自己话,猜一个字 	语 
自大加一点,猜一个字 	臭 
腿长胳膊短，眉毛遮住眼。没人不吭声，有人它乱窜。（打一动物名	蚂蚱
脱缰（打一运动项目名)	马拉松
脱粒机（打一成语）	吞吞吐吐
脚着暖底靴，口边出胡须。夜里当巡捕，日里把眼眯。（打一动物名	猫
脚儿小，腿儿高。戴红帽，穿白袍。（打一动物名	丹顶鹤
胜境（打一成语）	不败之地
背脸（打一成语）	其貌不扬
背板过海，满腹文章。从无偷窃行为，为何贼名远扬？（打一动物名	乌贼
胆大的耗子（打《水浒传》人物绰号一)	白日鼠
肥腿子，尖鼻子。穿裙子，背屋子。（打一动物名	鳖
肤浅之谈（打一中草药名)	陈皮
聚气守精（打宁夏一地名）	固原
耸人听闻,猜一字 	诡 
耳朵长，尾巴短。只吃菜，不吃饭。（打一动物名	兔子
者（打一成语）	有目共睹
老谋深算（打一中草药名)	苍术
老蚌生珠（打一中草药名)	附子
老板,猜一字 	住 
老式波音（打一歌曲名)	涛声依旧
老少多病（打宁夏一地名）	中宁
翘翘板（打一成语）	此起彼伏
羚羊散（打一字)	令
美梦（打一成语）	好景不长
美国小姐,猜一个字 	要 
美哉嘉陵（打云南一地名）	丽江
美人锁铜雀（打山东一地名）	鱼台
缺钱啦,猜一个字 	钦 
绿色长城（打一中草药名)	防风
绿林好汉（打一中草药名)	草蔻
绿化北京（打《水浒传》人名一)	燕青
绞刑架下的报告（打一文学名词)	悬念
给爷爷让座位（打天津一地名）	小站
给爷爷让座（打《水浒传》人名一)	孙立
给家捎个话（打一成语）	言而无信
结实累累 ,猜一个字 	夥 
结合本人（打《前出师表》一句）	俱为一体
绊脚石（打一字）	跖
终日琴堂醉未醒（打一词牌名)	如梦令
终年滴水（打一中草药名)	石见穿
纸老虎（打一成语）	外强中干
红袋子（打一中草药名)	赤包
红色为上（打《水浒传》人名一)	朱贵
红杏出墙（打湖南一地名）	花垣
红娘子，上高楼。心里疼，眼泪流。 （打一日常用品	蜡烛
红十字会（打一中草药名)	九一丹
繁荣的北京（打西藏一地名）	昌都
粽子脸，梅花脚。前面喊叫，后面舞刀。（打一动物名	狗
粮食（打一字）	稞
算命先生,猜一字 	仆 
第四季度经费（打一中草药名)	款冬花
第二次握手（打一字）	观
第一人称（打一歌曲名)	那就是我
笔走龙蛇（打一中药名)	通草
笑死人（打一成语）	乐极生悲
笑得前仰后合（打《水浒传》人物绰号一)	没面目
竹林诸贤堪赞颂（打一歌曲名)	七子之歌
竹林矛舍农家地,春耕缺水无心惜,猜一个字 	籍 
端午在眉睫（打一成语)	马首是瞻
章句不佳（打《三国演义》人名一)	文丑
站着百分高，躺着十寸长。裁衣做数学，它会帮你忙。（打一日常用品	尺
立足于走（打《水浒传》人物绰号一)	行者
窗前江水泛春色（打一中草药名)	空青
穿着大红袍，头戴铁甲帽。叫叫我阿公，捉捉我不牢。（打一动物名	蜈蚣
穿林而过（打一中草药名)	木通
空山之中一亩田           	画
空对空导弹（打一成语）	见机行事
空付一书扎（打江苏一地名）	高邮
空中霹雳（打《水浒传》人名一)	凌震
稻（打一字）	类
稀世珍宝（打一中草药名)	金不换
秘密部队（打《水浒传》人物绰号一)	神机军师
科举制度（打《前出师表》一句）	试用于昔日
禾薪入门（打《水浒传》人名一)	柴进
离别正堪悲（打一歌曲名)	欢聚
离别(分手),猜一字 	扮 
禁止调房（打《水浒传》人名一)	杜迁
祸及子孙（打《孙子兵法》一句）	不能善其后
票（打一成语）	闻风而起
神农架（打一字）	枢
神不在焉（打福建一地名）	仙游
祝福（打一字）	诘
社会在发展（打《水浒传》人名一)	史进
礼聘千万两,猜一字 	钟 
礼义廉耻,猜一个字 	罗
礼义廉耻,猜一个字 	罗(由「四维」得知) 
破门而入（打《孙子兵法》一句）	进而不可御者
石榴成熟（打一成语）	皮开肉绽
矮（打一字）	射
瞎子,猜一字 	盲 
眼看田上长青草,猜一字 	瞄 
眼看田上长青草,猜一个字 	瞄 
真情指数,猜一个字 	皓(告白) 
真心相伴,猜一字 	慎 
真丢人,猜一字 	直 
相声（打一成语）	装腔作势
盲人摸象（打一成语）	不识大体
目字加两点,别做贝字猜,猜一字 	贺 
目（打一字）	置
皮白腰儿细，会爬又会飞。木头当粮食，专把房屋毁。（打一动物名	白蚁
皇帝之袍          	袭
皇后在京坐正宫（打海南一地名）	琼中
皇（打一成语）	白玉无瑕
皂白何须问;       	七
百无一是（打一字）	白
百年前是草,百年后是木,猜一个字 	叶
百年前是草,百年后是木,猜一个字 	叶 
百岁老人（打一中草药名)	白头翁
百万雄兵卷白旗,天下无人去征西,秦王杀了余元帅,骂完一阵把马骑 ,猜四个字 	一二三四 
白娘子与小青（打《水浒传》人物绰号一)	两头蛇
白头谐老,猜一字 	舌 
白天一起玩，夜间一块眠。到老不分散，人夸好姻缘。（打一动物名	鸳鸯
登泰山而小天下（打《三国演义》人名一)	高览
痴（打一字）	保
留取丹心照汗青（打《史记》一句）	烈士润名
畅行无阻（打一中草药名)	路路通
画前画后费心思（打一字）	田
画前画后费心思           	田
画中人（打一字）	佃
男尊女卑（打《孙子兵法》一句）	贵阳而贱阴
男宾止步,猜一个字 	妪 
男女同眠,猜一个字 	好 
男士手携情人,猜一字 	接 
电锯开木头（打一成语）	当机立断
电梯（打一成语）	能上能下
甲子（打一电视剧名)	两个第一
甲乙丙丁戊己庚辛壬癸,猜一字 	旱 
田里雨后长青草,猜一个字 	蕾 
田心一片磁针石（打贵州一地名）	思南
田中,猜一字 	十 
田（打一成语）	挖空心思
用钱买官作（打《孙子兵法》一句）	因利而制权也
生的是一碗，煮熟是一碗。不吃是一碗，吃了也一碗。（打一动物名	田螺
生来青又黄，好比水一样。把它倒水里，它能浮水上。（打一日常用品	油
生在鸡家湾，嫁到竹家滩。向来爱干净，常逛灰家山。（打一日常用品	鸡毛掸子
生在山崖，落在人家。凉水浇背，千刀万剐。（打一日常用品	磨刀石
瓜熟蒂落。  	爪
瑞士（打一字）	佶
班超不作抄书吏（打《滕王阁序》一句）	有怀投笔
珍珠如土金如铁（打河南一地名）	宝丰
现代作品（打一新兴词语)	非典
玩儿房（打一歌曲名)	游戏人间
王昭君仰首看斜月,云天吊亡魂,猜一个字 	望 
王小明耳朵很大 今年十四岁 读一心国小 ,猜一个字 	听 
王小明耳朵很大 今年十四岁 读一心国小 	听 
王先生白小姐坐在石头上 ,猜一个字 	碧 
猫狗像什么（打一成语）	如狼似虎
猪年进宝（打一字)	赅
猪年献词（打一字)	该
猪八戒照镜子（打一中药名)	二丑
猜酒拳,猜一字 	批 
猜谜更使人生慧（打一中草药名)	益智
猛将百余人，无事不出城。出城就放火，引火自烧身。（打一日常用品	火柴
独眼龙,猜一字 	省 
独留花下人,有情却无心,猜一字 	倩 
独留花下人，有情却无心   	倩
独在异乡为异客（打《孙子兵法》一句）	亲而离之
狗脾气（打一字)	狄
狗王 ,猜一个字 	狂 
狗洞,猜一字 	突 
爿（打一字）	版
爸爸的耶诞节 ,猜一个字 	爷 
父故兄为长（打《红楼梦》人名一)	赖大
爱好旅游（打一成语）	喜出望外
爱兵如子（打《前出师表》一句）	将军向宠
爬竹竿（打一成语）	节节上升
熙熙攘攘（打一字）	侈
照相底片（打一成语）	颠倒黑白
热处理（打一字）	煺
烨（打一新兴词语)	中国热
烟缸（打一字）	盔
烟火灭后心安宁（打广东一地名）	恩平
点点是黄金,猜一个字 	全 
点点成金,猜一个字 	全 
炭（打一字）	樵
炉边火尽，须将意马牢拴           	驴
灰（打一字）	尘
火阑化贝 ,猜二个字 	烂货 
火烬炉冷平添意马心猿,猜一个字 	驴 
澄江浑如练（打《水浒传》人物绰号一)	浪里白条
潘仁美卖国（打内蒙古一地名）	通辽
漩涡里的歌（打西藏一地名）	曲水
演员谢幕时（打《红楼梦》人名一)	终了
满盘棋（打一中草药名)	无漏子
滔滔不绝（打一中草药名)	长流水
湖光水影接秋色（打一中草药名)	胡黄连
湖中倒影水纵横（打广东一地名）	潮州
渐渐安定（打《水浒传》人名一)	徐宁
清浊合流（打一成语）	泾渭不分
添丁进口,猜一字 	可 
海空优势（打《三国演义》人名一)	陆逊
海棠春睡（打一中草药名)	安息香
海上一只鸟，跟着船儿跑。冲浪去抓鱼，不怕大风暴。（打一动物名	海鸥
济人急难（打《水浒传》人名一)	施恩
测鼠（打一词牌名)	卜算子
流芳后世（打《三国演义》人名一)	孙尚香
流眼泪对流眼泪,猜一字 	器 
洪湖歌声融暮色（打《滕王阁序》一句）	渔舟唱晚
洞裏会郎君 ,猜一个字 	窥
洞裏会郎君 ,猜一个字 	窥 
洋婆子,猜一个字 	要 
泾渭不分（打吉林一地名）	浑江
泵（打一成语）	水落石出
注重生男,猜一字 	婢 
泥峰（打一字）	击
沫若乡间住处（打北京一地名）	郭公庄
没有哥哥,猜一字 	歌 
没关水龙头（打一成语）	放任自流
沟里走，沟里串。背了针，忘了线。（打一动物名	刺猬
沙漠一只船，船上载大山。远看像笔架，近看一身毡。（打一动物名	骆驼
池里不见水,地上不见泥,猜一个字 	也 
池塘亮底（打一字）	汗
江边点起两盏灯火,猜一个字 	淡 
江西如今变了样（打一字）	冷
汕头一周游（打一歌曲名)	山不转水转
汉朝文书（打《三国演义》人名一)	刘表
水映横山落残红（打一字）	绿
水库（打一字）	沧
水上工程,猜一个字 	汞 
氙氚（打一成语）	气吞山河
残局飘零满地金（打《三国演义》人名一)	黄盖
死而轻于鸿毛（打《史记》一句）	卒为天下笑
死对头,猜一字 	生 
武断（打一成语）	不容分说
武大郎设宴（打一成语）	高朋满座
武（打一字）	斐
此谜已破（打《水浒传》人物绰号一)	中箭虎
此日意无穷（打浙江一地名）	富阳
此客来意不善,猜一个字 	殡 
此字八横又八直,若问孔子也不知,猜一字 	哑 
此字不难猜,而且不分开,请问是那一个字 	面 
此字不难猜，而且不分开   	面
此字不难猜,孔子猜三天,请问是何字也 猜一个字 	晶(三天=三日) 
此字不奇怪,芬芳又自在,七人头上草,大家都喜爱,猜一个字 	花 
此字不凡仅四笔,无横无直无钩曲,皇帝见了要起身,圣人见了要施礼 ,猜一个字 	父 
此地景色佳,依山傍水真迷人,猜一个字 	汕 
正者日也（打湖北一地名）	当阳
正月无初一,猜一字 	肯 
正字少一横,不作止字猜,猜一个字 	步 
欲话无言听流水,猜一字 	活 
欲言又止,猜一个字 	认 
欲罢不能,猜一字 	四 
欧洲敬献皇帝之物（打香港一地名）	西贡
欧洲妇人,猜一个字 	要 
欧洲人,猜一个字 	伯 
樱桃小嘴,猜一个字 	如 
樱桃嘴,猜一字 	
横算直算,二四得八,猜一字 	买 
楼台接楼台，层层叠起来。上面飘白雾，下面水花开。（打一日常用品	蒸笼
楚霸王乌江自刎,猜一字 	翠 
楚剧选段（打黑龙江一地名）	林口
森林大火,猜一字 	焚 
梨桔柚各有其美（打《前出师表》一句）	此皆良实
梅须自逊三分白（打一中草药名)	雪里开
桃花满径日日开（打一电影名)	马路天使
桃李杏梅菊含笑（打广东一地名）	五华
桁（打一成语）	行将就木
根治黄河（打福建一地名）	清流
树旁站著两个人 ,猜一个字 	来 
树叶落尽（打江西一地名）	余干
柴门闻犬吠（打一字）	润
柳毅传书结连理（打《滕王阁序》一句）	喜托龙门
柳暗花明又一村（打河南一地名）	新乡
枫树无风,旁边有位老公,猜一个字 	松 
枪弹上膛（打一成语）	一触即发
林务大臣,猜一字 	棺 
极小（打一成语）	微乎其微
板（打一成语）	残茶剩饭
来者不善,猜一个字 	殡 
来日芬芳。               	禾
杜鹃啼血（打一中草药名)	红花
李时珍所著（打一字）	苯
李字少了木,不作子字猜,猜一字 	一 
未及格（打一字)	咩
木材遭水劫（打《水浒传》人名一)	林冲
木字多一撇 ,猜一个字 	(a)移; (b)朱 
木乃伊（打《史记》一句）	终不能化
望江亭（打一成语）	近水楼台
朔方有石无土培（打重庆一地名）	北碚
朋友半边不见了,猜一字 	月 
有轿不坐,有马不骑,今天二十九,明日初一,猜一个字 	赵 
有赚无赚饮淡薄（打《前出师表》一句）	至于斟酌损益
有话大家讲,猜一字 	讼 
有硬有软，有长有宽。白天空闲，夜晚上班。（打一日常用品	床
有目共睹 ,猜一个字 	者 
有手怀抱里,有脚想溜掉,有火点就跑 ,猜一个字 	包 
有手怀抱里,有脚想溜掉,有火点就跑 	包 
有心得志,猜一个字 	士
有心得志,猜一个字 	士 
有头没有尾，有角又有嘴。扭动它的角，嘴里直淌水。（打一日常用品	水龙头
有口亦难分诉,猜一字 	亚 
有位小姑娘，身穿黄衣裳。谁要欺负她，她就戳一枪。（打一动物名	黄蜂
有人无人都是你           	尔
有两个动物,一个在水里,一个在山上 ,猜一个字 	鲜 
有两个动物,一个在水里,一个在山上 	鲜
有上交,无下交;    	六
有一点不准（打一字）	淮
月光照进门,猜一个字 	闲 
暗中下围棋（打一成语）	皂白不分
智者千虑，必有一失（打《孙子兵法》一句）	得算多也
智力考核（打《孙子兵法》一句）	校之以计
晚会（打一字）	多
晓以大义（打福建一地名）	德化
显微镜（打一成语）	一孔之见
昨日不可留,猜一字 	乍 
春雨绵绵妻独睡 ,猜一个字 	一 
春草碧如丝（打《红楼梦》人名一)	翠缕
春秋配,猜一字 	秦 
春游芳草地（打一中草药名)	步步清
春水纵横送我还（打广西一地名）	梧州
春末夏初（打一字）	旦
春前秋后正寒时（打一中草药名)	天冬
春光临渡口（打山东一地名）	夏津
星星之歌,猜一字 	农 
易之而教之（打《孟子》一句）	迭为宾主
明知故问（打《前出师表》一句）	悉以咨之
明月下更惹人怜,猜四个字 	十月十日 
时已立秋（打《三国演义》人名一)	伏完
旱天雷（打一字）	田
旭日东升,猜一字 	九 
旭日不出,猜一个字 	九 
早不说晚不说（打一字）	午
早上（打一字）	日
日飞落树上，夜晚到庙堂。不要看我小，有心肺肝肠。（打一动物名	麻雀
日长月短左右战,一正一反两边排 ,猜一个字 	门 
日迈长安远（打一字）	宴
日落香残,洗凡心一点,猜一字 	秃 
日落香残，扫去凡心一点           	秃
日落相残洗却凡心一点,猜一个字 	秃 
日落半林中,猜一字 	东 
日照清流涌（打山西一地名）	阳泉
日照幽篁笼古刹（打广西一地名）	天等
日月一齐来（打一字）	胆
日复一日,猜一字 	昌 
日加直,不加点,猜一字 	神 
日（打一字）	畔
无风荷叶动,猜一字 	衡 
无限心头语,尽在情丝中,猜一字 	恋 
无脚也无手，身穿鸡皮皱。谁若碰着它，吓得连忙走。（打一动物名	蛇
无心的爱,猜一字 	受 
无底洞（打一成语）	深不可测
无头无尾一亩田 .,猜一个字 	鱼 
无可奈何花落去（打一常用词)	感谢
无丝竹之乱耳（打浙江一地名）	乐清
无一知其义也（打浙江一地名）	文成
旅行坐飞机,猜一字 	辈 
方言 ,猜一个字 	响 
方法论（打一中草药名)	白术
新苗茁壮（打一新兴词语)	小康
新竹,猜一字 	笋 
新媳妇探亲（打一歌曲名)	回娘家
斯已而已矣（打《孟子》一句）	可以止则止
断桥会许仙（打《水浒传》人物绰号一)	白面郎君
斩草不除根,猜一字 	早 
斩草不除根               	早
斑斓大虫（打《水浒传》人物绰号一)	锦毛虎
文起八代之衰（打《三国演义》人名一)	韩当
文武合一,猜一字 	斌 
文武两全,猜一字 	斌 
敲山震虎（打一中草药名)	驱风散
数说湖南掌故（打《红楼梦》人名一)	史湘云
故（打《史记》一句）	不离古文者近者
支出两分（打陕西一地名）	岐山
播种（打一动物名	布谷
接吻,猜一个字 	吕 
掌门人,猜一字 	们 
掌握自然规律（打《水浒传》人物绰号一)	摸着天
掌声经久不息（打北京一地名）	延庆
挥手告别,猜一个字 	军 
拿不出手,猜一字 	合 
拱手让人,猜一字 	共 
拨开云雾现红轮（打广东一地名）	揭阳
拦水坝（打一中草药名)	川断
抽水泵（打一字）	石
抵达分水处（打山西一地名）	临汾
抱千金而长叹（打《前出师表》一句）	可计日而待也
投身改革获褒奖（打台湾一地名）	彰化
把白米分给别人 ,猜一个字 	粉 
扰（打一成语）	半推半就
打边鼓（打一成语）	旁敲侧击
打断念头,猜一字 	心 
打开门有客来先脱帽再脱衣 ,猜一个字 	阁 
才超北斗（打《水浒传》人物绰号一)	智多星
才不明主弃（打《前出师表》一句）	亲贤臣
手无寸铁,猜一字 	控 
手提包,猜一个字 	抱 
手不释卷,猜一字 	卷 
所来全不费工夫（打《孙子兵法》一句）	不求而得
战太平（打江西一地名）	武宁
我自岿然不动（打《孙子兵法》一句）	守则有余
我的心,猜一个字 	悟 
我独不得出（打一字）	圄
我没有他有,天没有地有,猜一字 	也 
我欲乘风归去（打《三国演义》人名一)	苏飞
我丈夫也,猜一字 	余 
感冒通（打一成语）	有伤风化
愚公之家（打一成语）	开门见山
惩恶扬善（打云南一地名）	宜良
情投意合（打宁夏一地名）	同心
悔教夫婿觅封侯，只因陌头忽有见（打天津一地名）	杨柳青
悔当初,吾错失口   	五
恍然大悟（打一中草药名)	脑立清
总有一天出头日,猜一字 	春 
总是玉关情（打一字）	国
思想波动（打一文学名词)	意识流
思（打一字）	十
快快松绑（打一中草药名)	急解索
快刀斩乱麻（打一成语）	迎刃而解
忠诚老实（打一中草药名)	厚朴
忘（打一成语）	死心塌地
心如刀刺,猜一字 	必 
徒弟,猜一字 	们 
待到重阳日,猜一字 	晶 
彩调剧（打一成语）	声色俱厉
弹丸之地（打一字）	尘
弄瓦之徵 ,猜一个字 	姚 
弄瓦之喜 ,猜一个字 	姓 
弄璋之喜,猜一字 	甥 
异口同声（打一字）	谐
开门日正中（打一字）	间
建国方略,猜一字 	或 
庙建成菩萨到（打上海一地名）	新寺
店主站柜台（打山东一地名）	东营
应声而出（打《水浒传》人名一)	闻达
床前明月光（打一字）	旷
广厦千万间（打《孟子》一句）	大哉居乎
并非独生子（打《红楼梦》人名一)	丰儿
并重（打一成语）	恰如其分
年少无知（打湖北一地名）	大悟
平蛮十八洞（打《前出师表》一句）	今南方已定
平等待客（打一文学名词)	主人公
平日不思，中秋想你。有方有圆，又甜又蜜。（打一日常用品	月饼
平原门下客三千（打《滕王阁序》一句）	胜友如云
干涉（打一字）	步
席地谈天（打《孟子》一句）	位卑而言高
帝子乘风下翠微（打《滕王阁序》一句）	上出重霄
巨（打一字）	奕
左有十八,右有十八,二四得八,一八得八,猜一个字 	樊 
左有十八,右有十八,二四得八,一八得八 	樊 
左手五个，右手五个。拿去十个，还剩十个。（打一日常用品	手套
工（打《史记》一句）	用力曰功
峨嵋第一峰（打一中草药名)	川山甲
岸（打一字）	滂
岳父大人,猜一字 	仗 
岭上开花（打一中草药名)	山香
岩纹美丽（打《水浒传》人名一)	石秀
山花红烂漫（打内蒙古一地名）	赤峰
山水之间，一方独立（打重庆一地名）	涪陵
山外青山楼外楼（打《滕王阁序》一句）	层峦耸翠
山呼万岁（打河北一地名）	赞皇
山上复又山,猜一个字 	出,岳 
屡试屡成（打一动物名	百灵
尽收眼底（打一成语）	一览无遗
尖尖长嘴，细细小腿。拖条大尾，疑神疑鬼。（打一动物名	狐狸
尖（打《论语》一句）	小大由之
少年不识愁滋味（打《红楼梦》人名一)	焦大
小时像逗号，在水中玩耍。长大跳得高，是捉虫冠军。（打一动物名	青蛙
小小船，白布篷。头也红，桨也红。（打一动物名	鹅
小小狗，手里走。走一走，咬一口。（打一日常用品	剪刀
小姑娘,猜一个字 	妙 
小姑娘，夜纳凉。带灯笼，闪闪亮。（打一动物名	萤火虫
小人禁用（打一中草药名)	使君子
将言辞说上（打《前出师表》一句）	欲报之于陛下
将在谋不在勇（打《红楼梦》人名一)	智能
对着你的脸，按住你的心。请你通知主人翁，快快开门接客人。（打一日常用品	门铃
对方进了一球（打一字）	哼
对影成三人（打一字）	奏
寒凝大地发春华（打一中草药名)	冰凉花
寒从夜半起（打《红楼梦》人名一)	冷子兴
宿鸟恋枝头（打一字）	术
家母同样眼八只,猜四个字 	货真价实 
家书,猜一字 	响 
家乡话,猜一字 	响 
家中兄长多,一门共八个,猜一字 	阅 
室内外大清扫（打《三国演义》人名一)	普净
客人初至（打辽宁一地名）	新宾
宝岛姑娘,猜一字 	始 
宝岛姑娘,猜一个字 	始 
宗保不舍穆桂英,猜四个字 	巧言令色 
宋字去了盖,不做"木"字猜 猜一个字 	李 
安得后羿弓（打江苏一地名）	射阳
安居故里（打湖南一地名）	宁乡
守门狗,猜一字 	戾 
守株待兔（打一字)	柳
孩子丢了（打一字）	亥
学生学字,猜一字 	救 
学富五车（打《水浒传》人物绰号一)	智多星
学子远去,又见归来,猜一字 	觉 
学子远去，又见归来       	觉
孤灯如豆（打《水浒传》人物绰号一)	独火星
孤峦叠嶂层云散（打一字）	崛
存心不善,有口难言,猜一字 	亚
存心不善,有口难言,猜一字 	亚 
存心不善，有口难言       	亚 
字谜:群雁追舟—巡2110 ,猜一个字 	言 
孔明定下空城计,苏秦能说六国平,六郎要斩亲生子,宗保不舍穆桂英,猜四个字 	巧言令色 
孔子登山,猜一字 	岳 
子路欲谢之（打《前出师表》一句）	由是感激
子规啼尽杜鹃红（打一中草药名)	血竭花
子游（打《聊斋志异》一篇名)	鼠戏
子时报晓（打一电影片名)	半夜鸡叫
子仪出征讨禄山（打海南一地名）	定安
婚丧事（打一成语）	悲喜交加
娘子娘子，身似盒子。麒麟剪刀，八个钗子。（打一动物名	蟹
娘儿俩(打一字) 	姆
娘儿俩            	姆
娄阿鼠问卦（打一成语）	做贼心虚
威风扫地（打一中草药名)	虎力散
姑娘真辛苦，晚上还织布。天色蒙蒙亮，机声才停住。（打一动物名	纺织娘
妇女节前夕（打一中草药名)	三七
如箭在弦,猜一字 	引 
好鸟无心恋故林,吃罢昆虫乘风鸣,八千里路随口到,鹧鸪飞去十里亭 ,猜四个字 	鸾凤和鸣 
好鸟无心恋故林,吃罢昆虫乘风鸣,八千里路随口到,鹧鸪飞去十里亭 ,猜四个字	鸾凤和鸣 
好鸟无心恋故林,吃罢昆虫乘风鸣,八千里路随口到, 	
好读书（打一字）	敞
好读书（打《论语》一句）	学而不厌
好歹分到房一套（打《前出师表》一句）	优劣得所也
女孩男孩一个样（打《红楼梦》人名一)	平儿
女十八兮叹分离（打《红楼梦》人名一)	杏奴
奥运射击冠军（打《水浒传》人物绰号一)	金枪手
头顶两只角，身背一只镬。只怕晒太阳，不怕大雨落。（打一动物名	蜗牛
头胖脚掌大，像个大傻瓜。四肢短又粗，爱穿黑大褂。（打一动物名	熊
头楚尾,猜一字 	足 
头插花翎翅，身穿彩旗袍。终日到处游，只知乐逍遥。（打一动物名	蝴蝶
头戴周瑜帽，身穿张飞袍。自称孙伯符，脾气像马超。（打一动物名	蟋蟀
头寸不足,猜一字 	钦 
头大尾细，全身生疥。拿起索子，跟你讲价。（打一日常用品	秤
头前两把刀，钻地害禾苗。捕来烘成干，一味利尿药。（打一动物名	蝼蛄
失其心也,猜一个字 	共 
夫妻量刑不同（打《前出师表》一句）	使内外异法也
夫妻同戴光荣花（打《红楼梦》人名一)	双红
夫人何处去,猜一字 	二 
太阳西边下,月儿东边挂,猜一字 	明 
太阳王 ,猜一个字 	旺 
太阳灶（打一成语）	热火朝天
太阳挂在树顶上,猜一个字 	果 
太太,猜一字 	夫 
天际孤帆愁别离（打一字）	穗
天涯海角（打一歌曲名)	在那遥远的地方
天寒音讯稀（打《红楼梦》人名一)	雪雁
天女散花（打一新兴词语)	高消费
天女散花（打一中草药名)	降香
天天,猜一个字 	晦 
天各一方话鼠（打一画家名)	吴道子
天不绝曹（打《三国演义》人名一)	魏延
天上无二,合去一口,家家都有,猜一字 	人 
大雨落在横山上,猜一字 	雪 
大火烧到耳朵边           	耿
大河没水小河干           	哥
大楼皆是鸳鸯楼（打《滕王阁序》一句）	洪都新府
大有头中无心小全身       	京
大有头,中无心,小全身 ,猜一个字 	京 
大开绿灯（打一中草药名)	路路通
大人挑小人 ,猜一个字 	夹 
大丈夫不得出头,猜一个字 	天 
夜半无人私语时（打一文学名词)	黑色幽默小说
多看无滋味（打一成语）	屡见不鲜
多兄长（打一动物名	八哥
多一半,猜一字 	夕 
外麻里光，住在闺房。姑娘怕戳疼，拿它来抵挡。（打一日常用品	顶针
塞鸿何因又南飞（打《滕王阁序》一句）	雁阵惊寒
城府极深（打《水浒传》人物绰号一)	共同反对使用外挂，打击外挂，从你我做起。
垃圾箱（打一成语）	藏垢纳污
垂涎三尺（打一文学名词)	顺口溜
坚持到底（打《史记》一句）	虽死不易
坚决煞住吃喝风（打《滕王阁序》一句）	盛筵难再
坐定左右无人,猜一字 	土 
在地愿为连理枝（打《孙子兵法》一句）	故合之以交
土上有竹林,土下一寸金,猜一个字 	等 
圆寂（打一成语）	坐以待毙
固若金汤（打河北一地名）	保定
回答者： 魔法师耍宝 - 一级    2009-11-13 20:35 	
回答者： 剑客的书童 - 一级    2009-11-13 20:04 	
回答者： 1998赵 - 一级    2009-11-13 19:10 	
回归洛阳（打《前出师表》一句）	还于旧都
四面都是山,山山皆相连 ,猜一个字 	田 
四面屯粮（打《三国演义》人名一)	周仓
四通八达（打一成语）	头头是道
四知美誉留人世（打《史记》一句）	其行廉
四柱八栏杆，住着懒惰汉。鼻子团团转，尾巴打个圈。（打一动物名	猪
四方面军（打一歌曲名)	东西南北兵
四方一条心（打一字）	愣
四撇一弯钩，虫在肚中留  	蜀
四川的狗,猜一个字 	独 
四山纵横 ,两日稠缪 ,富由他起脚 ,累是他领头 	田 
四山纵横 , 两日稠缪 , 富由他起脚 , 累是他领头,猜一个字 	田 
四个晚上（打一字）	罗
嘴（打一字）	唧
唐老鸭退役 ,猜一个字 	鸟 
唐太宗登基（打《红楼梦》人名一)	李贵
唐太宗作帝范篇（打《三国演义》人名一)	李典
哭声直上干云霄（打《史记》一句）	楚人之多也
哥哥相亲（打《水浒传》人名一)	顾大嫂
哑巴打手势（打一成语）	不言而喻
和局（打一字）	抨
和尚拜佛 ,猜一个字 	拿 
咄（打一成语）	脱口而出
周瑜死因（打《孙子兵法》一句）	将不胜其忿
呀（打一成语）	唇齿相依
吾妻,猜一个字 	肉(内人) 
吴头楚尾,猜一字 	足 
向阳坡上桃花艳（打广西一地名）	南丹
后继无人（打一中草药名)	续断
后村闺中听风声（打一字）	封
同光阴赛跑（打一新兴词语)	与时俱进
司马中原,猜一个字 	魂(说鬼) 
叶飘时零客人来（打新疆一地名）	喀什
叶公（打一古动物名)	恐龙
可烧而走也（打《前出师表》一句）	然后施行
叫猫不抓鼠，像熊爱吃竹。摇摆惹人爱，是猫还是熊？（打一动物名	熊猫
只是近黄昏 ,猜一个字 	酱 
另有变动（打一字）	加
句句扣心弦（打《四书》一句）	言必有中
古时候的月亮,猜一字 	胡 
古文观止（打一字）	故
古城姐妹（打一中草药名)	金银花
古代文化（打《三国演义》人名一)	史迹
口道恒河沙复沙（打《史记》一句）	不可胜数
口比肚子大，给啥就吃啥。它吃为了你，你吃端着它。（打一日常用品	碗
叔伯昆仲（打陕西一地名）	咸阳
发扬大协作精神（打青海一地名）	互助
反比,猜一个字 	北 
双手赞成（打一成语）	多此一举
双双无突破（打吉林一地名）	四平
双兔傍地走（打《史记》一句）	则雌雄之所，在未可知也
又白又软，罩住人脸。守住关口，防止传染。（打一日常用品	口罩
又到鸡西市（打黑龙江一地名）	双城
参观航空（打《三国演义》人名一)	张飞
去了上半截,有了下半截,比成两半截,又无下半截 ,猜一个字 	熊 
去了上半截,有了下半截,比成两半截,又无下半截 	熊 
去一人还有一口，去一口还有一人。	合
去一人还有一口，去一口还有一人	合
厩（打一字）	驴
卧倒（打一成语）	五体投地
南人不复反矣（打四川一地名）	泸定
单方告别（打一成语）	一面之词
单刀赴会（打《水浒传》人名一)	关胜
单人床（打一字）	庥
华而不实（打一植物名	无花果
华夏英姿（打一新兴词语)	中国特色
华夏大地沧桑史（打台湾一地名）	中坜
半耕半读（打一字）	讲
半真半假,猜一个字 	值 
半推半就,猜一字 	掠 
半导体（打一字）	付
半出半进,猜一字 	崔 
半个西瓜样，口朝上面搁。上头不怕水，下头不怕火。（打一日常用品	锅
半个月亮,猜一个字 	胖 
半个人,猜一个字 	伴 
千金散尽还复来（打《史记》一句）	用而不匮
千里通电话（打一成语）	遥相呼应
千里相思一撇消."  	十
千里相会见真心（打台湾一地名）	三重
千里来慰问（打黑龙江一地名）	抚远
千里姻缘一线牵 ,猜一个字 	重 
千言万语,猜一字 	够 
千街万巷没堵塞（打青海一地名）	大通
千古结同心        	恬
十月十日(武昌起义),猜一字 	朝 
十月十日,猜一个字 	萌 
十日画一水（打一字）	洵
十字架下三个人,猜一个字 	来 
十字对十字,太阳对月亮,猜一个字 	朝 
十八乘十六（校） 	
十元买早餐,八元买豆干 ,猜一个字 	干 
十人九死焉（打一中草药名)	独活
十五天 ,猜一个字 	胖 
十五人,猜一字 	伞 
十二点 ,猜一个字 	斗 
十个哥哥 ,猜一个字 	克 
十三点 ,猜一个字 	汁 
十一个读书人 ,猜一个字 	仕 
十（打一成语）	纵横交错
区区小事竟当真（打一电影片名)	鸡毛信
北行竟迷途（打《四书》一句）	上失其道
北平解放之后（打四川一地名）	成都
化妆学（打一成语）	谈何容易
包头界首（打一字）	甸
勿上当（打一新兴词语)	非典
加的结果乃能大（打新疆一地名）	和硕
加减乘除少一点           	坟
加减乘除（打一文学名词)	构成主义
前面来只船，舵手在上边。来时下小雨，走后路已干。（打一日常用品	熨斗
前藏安家，怡然开心（打天津一地名）	芦台
前不着村，后不着店（打《孙子兵法》一句）	行无人之地也
到处碰壁（打《论语》一句）	不得其门而入
到了长城放声唱（打一歌曲名)	好汉歌
判决无罪,猜一个字 	皓
判决无罪,猜一个字 	皓 
判（打一成语）	一刀两断
初一（打一成语）	日新月异
刚刚平静（打湖南一地名）	新宁
刘邦登基诏书（打四川一地名）	宣汉
刘关张结义遗址（打台湾一地名）	桃园
分开不用刀;       	八
分床不分家（打浙江一地名）	桐庐
分兵出发（打一中草药名)	行军散
刃（打一字）	召
刀出鞘,猜一字 	力 
出自幽谷,迁於乔木,猜一个字 	呆 
出一半有何不可,猜一字 	仙 
凤头虎尾（打一字）	几
准点到西宁（打江苏一地名）	淮安
决心扎根边疆（打一中草药名)	远志
冲着你打（打内蒙古一地名）	和林格尔
冰（打一字）	涸
冬初秋末（打一字）	八
农产品（打一成语）	土生土长
写下面（打一字）	与
再三谦让（打《三国演义》人名一)	陆逊
再三让贤（打《水浒传》人名一)	陆谦
再（打一字）	变
内里有人（打一字）	肉
内秀（打一新兴词语)	心灵美
养猪专业户（打一字)	阂
兵家必争之地（打香港一地名）	旺角站
关帝庙（打一字）	扇
共同走江湖（打山西一地名）	洪洞
兰香幽谷无人问（打《红楼梦》人名一)	花自芳
六王毕，四海一。（打《红楼梦》人名一） 秦邦业	
六十不足,八十有余,猜一字 	平 
公而忘私,猜一字 	八 
公私仓廪皆丰实（打海南一地名）	屯昌
公用毛巾（打一成语）	面面俱到
公开赞助（打湖北一地名）	襄阳
公安人员的任务（打《三国演义》人名一)	管宁
八骏日行三万里（打《三国演义》人名一)	马良
八戒过火焰山（打一菜肴名)	红烧猪蹄
八戒娶媳妇（打一影视剧名)	猪的喜剧
八十八（打一成语）	入木三分
八十八 ,猜一个字 	米 
八兄弟同赏月,猜一个字 	脱 
八一勋章（打辽宁一地名）	彰武
全面整顿（打云南一地名）	大理
全面开荒（打一成语）	不留余地
全民皆兵（打《孙子兵法》一句）	齐之以武
入门无犬吠（打一字）	问
兔年初春色刚浓（打一作家名)	柳青
兔子请老虎（打一成语）	寅吃卯粮
兔唇（打一京剧名)	三岔口
兔儿头上戴顶帽，满腹苦水无处申   	冤
光杆司令（打《孙子兵法》一句）	将不重也
光启族人大团圆（打上海一地名）	徐家汇
先收集然后整理（打河南一地名）	焦作
先天下之忧而忧（打《三国演义》人名一)	甘后
兄有债,猜一字 	歌 
兄有债,猜一字 	歌 兄弟姐妹 
兄有债,猜一字 	歌 
兄弟姐妹,猜一字 	捉 
兄弟七八千，住在屋檐边。日日做浆卖，浆汁更值钱。（打一动物名	蜂
兄弟（打一成语）	数一数二
元前明后（打《水浒传》人名一)	宋清
儿行母忧（打一中草药名)	相思子
儿童节发假（打一中草药名)	六一散
僧穿彩衣（打《水浒传》人物绰号一)	花和尚
像鱼不是鱼，终生住海里。远看是喷泉，近看像岛屿。（打一动物名	鲸
像猫不是猫，身穿皮袄花。山中称霸王，寅年它当家。（打一动物名	老虎
傻瓜 ,猜一个字 	保 
傀儡（打《孟子》一句）	为其像人而用之也
偷梁换柱（打一中草药名)	木贼
偏听偏信（打《史记》一句）	此与以耳食无异
假眼（打一成语）	目不转睛
值钱不值钱,全在这两点,猜一个字 	金 
借问酒家何处有（打《红楼梦》人名一)	探春
信徒称耶稣,猜一字 	注 
保持沉默（打一歌曲名)	什么也不说
保卫珍宝岛之战（打香港一地名）	北角
促其反正（打吉林一地名）	敦化
依然故我（打云南一地名）	个旧
依山傍水,猜一个字 	汕 
依人篱下（打一中草药名)	寄生
使女择焉（打《孟子》一句）	决汝汉
佳作已见报（打山东一地名）	文登
你打我不恼，背后有人挑。心中亮堂堂，指明路一条。（打一日常用品	灯笼
你坐我不坐，我行你不行。你睡躺得平，我睡站到明。（打一动物名	马
何需杀人灭口,猜一字 	丁 
何谓状元（打一文学名词)	第一人称
何谓五岳（打辽宁一地名）	盘山
住在黄金屋 ,猜一个字 	锯 
低头思故乡（打一中草药名)	怀熟地
但愿一识韩荆州（打《前出师表》一句）	不求闻达于诸侯
伯父隔壁没住人 ,猜一个字 	白 
伞兵（打一成语）	从天而降
会计（打一成语）	足智多谋
众说纷纭已卯年（打一食物商标)	大白兔
众芳竞艳（打《水浒传》人名一)	花荣
众（打一字）	侈
休要丢人现眼,猜一字 	相 
休得多言（打一文学名词)	歇后语
伊丽沙白,猜一字 	瑛 
以柔克刚者胜（打《孙子兵法》一句）	无勇功
仙乐（打一成语）	不同凡响
付出爱心,猜一个字 	受 
他乡遇故知（打一中草药名)	一见喜
仕绅中一人未见,邀朋友只请半边,大清斗乌云遮日,明月下更惹人怜,猜四个字 	十月十日 
仕绅中一人未见,邀朋友只请半边,大清斗乌云遮日, 	
从打工起，终于出头（打重庆一地名）	巫山
从今莫把仇人靠    	九
介胄之士（打湖北一地名）	武汉
介子推辞官退隐（打安徽一地名）	潜山
人间四月芳菲尽（打一中草药名)	春不见
人都到了 ,猜一个字 	倒 
人的品格最重要（打青海一地名）	贵德
人有他则变大,猜一个字 	一 
人无寸铁,猜一个字 	控 
人无信不立,猜一字 	言 
人我不分,猜一个字 	俄 
人微言轻（打一文学名词)	小小说
人家在何处（打《前出师表》一句）	不知所云
人在楼头空伫立（打安徽一地名）	休宁
人不在其位 ,猜一个字 	立 
亚（打一成语）	有口难言
五月既望（打一中草药名)	半夏
五日之家,外种一树,猜一个字 	梧 
五十对耳朵 ,猜一个字 	陌 
互吻,猜一字 	吕 
云破月来,猜一字 	育 
云南大旱,猜一字 	滇 
于今好运到门前（打《红楼梦》人名一)	来旺
于予与何诛（打《论语》一句）	我无言责之
二小姐 ,猜一个字 	姿 
二十四小时（打一字）	旧
二八佳人 ,猜一个字 	妙 
二兄弟,各自立 ,猜一个字 	竞 
二世朝廷扫地空（打《史记》一句）	卒亡其国
二三四五六七八九（打一成语）	缺衣少食
事事齐全说汉高（打《三国演义》人名一)	刘备
争先恐后（打一字）	急
乾燥剂 ,猜一个字 	法 
书签（打一字）	颊
九辆车,猜一个字 	轨 
九点,猜一字 	丸 
九死一生（打一中草药名)	独活
九号,猜一字 	旭 
九只鸟,猜一个字 	鸠 
九十九,猜一字 	白 
九九归一（打一中草药名)	百合
乘人不备,猜一字 	乖 
乖（打一成语）	乘人不备
乍得人（打一字）	作
久雷不雨,猜一字 	田 
久雷不雨                 	田
久旱逢甘露（打《水浒传》人物绰号一)	及时雨
久别重逢（打一中草药名)	一见喜
举重比赛（打一成语）	斤斤计较
举起鞭儿又紧缰（打新疆一地名）	策勒
主人无恙（打湖南一地名）	东安
主（打一成语）	一往无前
为虎作伥（打陕西一地名）	扶风
为天下唱（打内蒙古一地名）	呼和浩特
为储户保密（打《四书》一句）	慎言其余
为你打我，为我打你。打到你皮开，打得我出血。（打一动物名	蚊子
丹田（打一歌曲名)	红土地
丹江（打一字）	洙
丹朱（打一字）	赫
丰衣足食（打《孟子》一句）	黎民不饥不寒
丰收年,猜一字 	移 
丰收（打一字）	移
中间是火山，四边是大海。海里宝贝多，快快捞上来。（打一日常用品	火锅
中秋夜乌云密布,猜一字 	胞 
中的（打一成语）	矢无虚发
中心一点口不见,猜一个字 	卜 
中国话,猜一个字 	哗 
中国界首（打河北一地名）	玉田
中国振兴更辉煌（打上海一地名）	龙华
中华腾飞（打《水浒传》人物绰号一)	入云龙
个儿高又大，脖子似吊塔。和气又善良，从来不打架。（打一动物名	长颈鹿
严寒时节郁葱葱（打一中草药名)	冬青
两耳不闻窗外事（打一歌曲名)	惟一的思念
两眼如灯盏，一尾如只钉。半天云里过，湖面过光阴。（打一动物名	蜻蜓
两狗谈天,猜一字 	狱 
两点水,猜一字 	冰 
两点天上来（打一字）	关
两点一直,一直两点,猜一字 	慎 
两横一竖打一字（打一中草药名)	射干
两对情人互相思（打一歌曲名)	好想好想
两字相乘二十一（打一中草药名)	三七
两地相思,猜一字 	桂 
两人一般心,猜一字 	患 
两个少女（打一中草药名)	二妙散
丢盔弃甲（打一中草药名)	败酱
东洋兵,猜一个字 	晕 
东施（打一字）	妞
东南西北皆欲往（打一歌曲名)	走四方
世界冠军（打《孟子》一句）	无敌于天下
世界冠军（打《史记》一句）	威震天下
与我同行,猜一个字 	衙 
与人方便,猜一字 	更 
不许说大话（打一文化用品)	牛皮封
不许你发达（打《水浒传》人名一)	杜兴
不讲理的人,猜一字 	地 
不要走（打一字）	还
不要讲话,猜一个字 	吻 
不要和陌生人说话（打一常用词)	熟语
不考虑中间（打一成语）	瞻前顾后
不知道（打一中草药名)	生地
不知木兰是女郎（打《史记》一句）	阴阳有变
不省人事（打《孙子兵法》一句）	知天知地
不生第二胎（打一中草药名)	杜仲
不甘落后（打《水浒传》人名一)	乐进
不欢而去（打一中草药名)	失笑散
不是车            	辈
不怕火（打一字）	镇
不寻常的秀才（打《水浒传》人物绰号一)	圣手书生
下不为例（打江西一地名）	上饶
上面正差一笔，下面少去一点。	步
上下难分,猜一字 	卡 
上下四方无险情（打安徽一地名）	六安
上下合,猜一个字 	卡 
上下串通,猜一个字 	卡 
上下一体（打一字）	卡
三省吾身（打一中草药名)	防己
三点河旁落（打一字）	可
三张纸,猜一个字 	顺 
三口重叠,莫把品字猜,猜一个字 	目
三口重叠,莫把品字猜,猜一个字 	目 
三十六载共患难（打贵州一地名）	桐梓
三军过后尽开颜（打《史记》一句）	卒相与欢
三八多面手（打《红楼梦》人名一)	巧姐
三人骑头无角牛    	奉
三人两口一匹马,猜一字 	验 
三九时节（打一中草药名)	天冬
三丫头（打一字）	羊
万象更新百花红（打一中草药名)	回春丹
万紫千红总是春（打《史记》一句）	当时则荣
万物之灵,猜一个字 	他(人也) 
七十二小时,猜一个字 	晶 
七人头上长了草,猜一字 	花 
七人八只眼,猜一个字 	货 
七个人有八只眼,十人亦有八只眼,西洋人也眼八只,家母同样眼八只,猜四个字 	货真价实 
一颗小红枣，一屋盛不了。只要一开门，枣儿往外跑。（打一日常用品	油灯
一队胡子兵，当了牙医生。早晚来巡逻，打扫真干净。（打一日常用品	牙刷
一钩残月带三星    	心
一边是红,一边是绿,一边喜风,一边喜雨,猜一个字 	秋 
一边是红,一边是绿,一边喜风,一边喜雨 	秋 
一边是水,一边是山,猜一个字 	汕 
一路无事故（打《水浒传》人名一)	安道全
一起作东家 （打北京一地名）	同合庄
一表非凡（打一文学名词)	神话
一藤连万家，家家挂只瓜。瓜儿长不大，夜夜会开花。（打一日常用品	电灯
一群黄鸡娘，生蛋进船舱。烤后一声响，个个大过娘。（打一日常用品	爆米花
一索功高缚楚王（打《史记》一句）	信而不疑
一直真心相对（打一字）	非
一百减一 ,猜一个字 	白 
一生离乱（打《水浒传》人名一)	牛二
一物三口，有腿无手。谁要没它，难见亲友。（打一日常用品	裤子
一点一点得知（打一字）	短
一点一横长,一撇到南洋,南洋有个人,只有一寸长,猜一个字 	府 
一点一横长,一撇到南洋,南洋有个人,只有一寸长 	府 
一江春水向东流（打一中草药名)	通大海
一棵麻，多枝丫。雨一淋，就开花。（打一日常用品	雨伞
一根木棍,吊个方箱,一把梯子,搭在中央 ,猜一个字 	面 
一根木棍,吊个方箱,一把梯子,搭在中央 	面 
一样物，花花绿。扑下台，跳上屋。（打一动物名	猫
一朝选在君王侧（打《红楼梦》人名一)	杨侍郎
一望无际（打《三国演义》人名一)	张辽
一月七日,猜一个字 	脂 
一曲高歌夕阳下    	曹
一星星，一点点。走大路，钻小洞。（打一动物名	蚂蚁
一斗米,猜一个字 	料 
一支香烟（打一文学名词)	传奇人物
一支香，地里钻。弯身走，不会断。（打一动物名	蚯蚓
一撇画了三寸长           	寿
一把刀，顺水漂。有眼睛，没眉毛。（打一动物名	鱼
一帆风顺无险阻（打青海一地名）	平安
一家有七口,种田种一亩,自己吃不够,还养一条狗 ,猜一个字 	兽 
一家有七口,种田种一亩,自己吃不够,还养一条狗 	兽 
一家十一口,猜一字 	吉 
一字十三点,难在如何点 ,猜一个字 	汁 
一大二小,猜一个字 	奈 
一夜又一夜,猜一字 	多 
一块变九块（打一成语）	四分五裂
一只黑鞋子，黑帮黑底子。挂破鞋子口，漏出白衬子。（打一日常用品	西瓜子
一只黑狗，两头开口。一头咬煤，一头咬手。（打一日常用品	火钳
一只罐，两个口。只装火，不装酒。（打一日常用品	灯笼
一只狗四个口,猜一个字 	器 
一只牛,猜一个字 	生 
一只没脚鸡，立着从不啼。吃水不吃米，客来敬个礼。（打一日常用品	茶壶
一只八宝袋，样样都能装。能装棉和纱，能装铁和钢。（打一日常用品	针线包
一口咬破衣（打一字）	哀
一口咬定,猜一字 	交 
一口咬去多半截。	名
一口吃掉牛尾巴,猜一个字 	告 
一半儿,猜一个字 	臼 
一劳永逸（打陕西一地名）	长安
一加一,猜一字 	王 
一人腰上挂把弓,猜一字 	夷
一人腰上挂把弓,猜一字 	夷 
一人腰上挂把弓    	夷
一人背张弓（打一字）	夷
一人挑两小人,猜一字 	夹 
一人在内,猜一字 	肉 
一人一张口,口下长只手,猜一字 	拿 
一人 ,猜一个字 	大 
一个礼拜 ,猜一个字 	旨 
一个人搬两个土 ,猜一个字 	佳 
一一箭穿心,猜一字 	必 
一一入史册（打一字）	更
一（打一成语）	接二连三
4个人搬个木头 ,猜一个字 	杰 
2110 ,猜一个字 	言 
《聊斋志异》（打一成语）	鬼话连篇
　金乌西坠白头看（打河南一地名）	洛阳
